ACAAAAAAAAAAA
ACAACAAAAAAAA
ACCCACAAAAAAA
AAAAAAAAAAAAA
ACCCCCCCAAAAA
AAAAAAAAAAAAA
CCACCCCCAAAAA
ACACAAAAAAAAA
ACACAAAAAAAAA
AAAAAAAAAAAAA
AAAAAAAAAAAAA
AAAAAAAAAAAAA
AAAAAAAAAAAAA