ABAAAAAAAAAAA
ABAABAAAAAAAA
ABBBABAAAAAAA
AAAAAAAAAABAA
ABBBBBBBAAAAA
AAAAAAAAAAAAA
BBABBBBBAAAAA
ABABAAAAAAAAA
ABABAAAAAAAAA
AAAAAAAAAAAAA
AAAAAAAAAAAAA
AAAAAAAAAAAAA
AAAAAAAAAAAAA